8x8
WWPPPMMM
WWWPPPMM
WPFPFFPP
WWPPPPPP
WPFPCPPC
MMFPPPPM
MMMMMMMM
MMMMMMMM
CANNON_3,0
FLYING_1,2
TANK_7,3